+--+--+--+--+--+--+--+--+----+    
|                            |    
|           +--+--+-+--+     |    
|           |          |     +    
|     +--+--+          +     |    
|     |                |     +    
+--+--+    +--+--+--+--+     |    
           |                 +    
           |                 |    
           +--+--+--+-+   -+--+--+
                      |         g+
                      |          +
                      +--+----+--+