+--+--+--+--+--+--+--+--+----+    
|     L                      |    
|           +--+--+-+--+     |    
|           |          |     +    
|     +--+--+          +     |    
|g    |                |     +    
+--+--+    +--+--+--+--+     |    
           |                 +    
           |                 |    
           +--+--+--+-+   -+L-+--+
                      |          +
                      |          +
                      +--+----+--+