+--+--+--+--+--+--+--+--+----+    
|     L                      |    
|           +--+--+-+--+     |    
|           |          |     +    
|     +--+--+          +     |    
|     |                |     +    
+--+--+    +--+--+--+--+     |    
           |                 +    
           |                 |    
           +--+--+--+-+   -+L-+--+
                      |         g+
                      |          +
                      +--+----+--+