                  +--+--+-+                                        
                  |       |                                        
                  |       |                                         
+--+--+--+--+--+--+       |                                        
|             s   L       |                                        
L                 L       +--+--+--+--+--+--+--+--+--+             
L                                                    |             
|                                                    |             
+--+--+--+--+--+--+--+--+--+--+--+                   |             
                                 |                   |             
                                 |                   |             
                                 |                   |             
                                 |                   |             
                                 |                   |             
                                 |                   |             
                                 |                   |             
                                 |         g         |             
                                 L                   |             
                                 |                   |             
                                 |                   |             
                                 |                   |             
                                 |                  +              
                                 |                 +               
                                 |                +                
                                 |               +                 
                                 |              +                  
                                 |        +----+                   
                                 |        |     +--+--+--+--+--+--+
                                 |        |     |                 |
                                 |        |     L                 |
                                 |        |     |                 |
                        +--+--+--+        |     |                 |
                        |                 |--+--+                 |
                        |                 |                       |
                        |                                         |
                        |                                         |
                        |                                         |
                        +--+--+--+--+--+--+--+--+--+--+--+--+--+--+