+--+--+--+--+--+--+--+--+----+    
|                            |    
|           +--+--+-+--+     |    
|           |          |     +    
|     +--+--+          +     |    
|g    |                |     +    
+--+--+    +--+--+--+--+     |    
           |                 +    
           |                 |    
           +--+--+--+-+   -+--+--+
                      |          +
                      |          +
                      +--+----+--+